7,2,8,8,0,1,8,0,1,2
1,12,0,8,0,0,1,9,8,1
0,6,0,6,2,0,0,0,0,1
4,2,6,4,0,0,2,1,0,1
4,4,0,4,0,0,0,0,1,0
4,0,6,6,0,0,0,0,1,1
0,6,4,0,0,0,0,0,1,0
6,4,4,0,6,0,0,0,0,1
4,4,0,6,4,4,0,0,0,1
0,0,2,2,2,4,2,2,0,0
